000001000000000
010000000000001
000011000000000
000011000000000
000000000010000
000000000011000
000001000011000
001100000000000
001100000010000
100000000000000
100000000000000