000001000200220
010002202200021
000011200002220
222211202000000
000220222212222
000022000211000
002221020211000
221122222022222
221100022010000
122200002020000
122200000020000